Supermarket : chāo shì 超市
When : dāng 当
Room : fáng jiān 房间
Straight : yī zhí 一直
Office : bàn gōng shì 办公室
Back : hòu bèi 后背
Car : qì chē 汽车 / xiǎo chē 小车
Achieve : zuò dào 做到
Market : shì cháng 市场
Use : yòng 用
Prepare : zhǔn bèi 准备
Thirsty : kǒu kě 口渴
Centre : zhōng xīn 中心
Boat : chuán 船
Soup : tāng 汤
Move : dòng 动
Recently : zuì jìn 最近
To Hurt : shāng hài 伤害
Or : huò zhě 或者
Fire : huǒ 火
Decide : jué dìng 决定
Welcome : huān yíng 欢迎
Find : zhǎo dào 找到
Finally / At Last : zuì hòu 最后
The Best : zuì hǎo 最好
Heavy : zhòng 重
Important : zhòng yào 重要
Word : zì 字
Being : zhèng zài 正在
Knowledge : zhī shi 知识
Station : zhàn 站
Some : yǒu xiē 有些 / yǒu de 有的 / yī xiē 一些
Many : hěn duō 很多
A While : yí huì r 一会儿
Clothes : yī fu 衣服
New : xīn shēng 新生
Next Time : xià cì 下次
Wash : xǐ 洗
Forget : wàng jì 忘记
Fruit Juice : guǒ zhī 果汁
Inside : lǐ 里 / lǐ biān 里边
Surface : miàn 面
Joking : kāi wán xiào 开玩笑
House : fáng zi 房子
Work : gōng zuò 工作 / bān gōng 班工
Looking Forward To / Expecting : qī dài 期待
Thing / Stuff : dōng xī 东西
Centre : zhōng jiān 中间 / zhōng xīn 中心
Which : nǎ 哪
There : nà r / nà li 那
Put Into : fàng jìn 放进
Fruit Juice : guǒ zhī 果汁
Just Now / A Moment Ago : gāng cái 刚才
Just / Exactly : gāng hǎo 刚好
Saliva : kǒu shuǐ 口水
Hear : tīng dào 听到
Shopping : gòu wù 购物
Embarrassed : gān gà 尴尬
Sleepy : kùn 困
Tired : lèi 累
Stand Up : qǐ lái 起来
Washed : xǐ guò le 洗过了
Hair : tou fā 头发
Inside Car : chē shàng 车上
Train Station : chē zhàn 车站
Hobby : ài hǎo 爱好
Daytime : bái tiān 白天
No Need To : bù yòng 不用
Often : cháng cháng 尝尝
Lucky : xìng yùn 幸运
Hope : xī wàng 希望
Heavy : zhòng 重
Important : zhòng yào 重要
Boring : bù hǎo wán 不好玩
Permit / Allow : ràng 让
Mood : xīn qíng 心情
Dark : hēi àn 黑暗
Read : dú shū 读书
End / Termination : zhōng zhǐ 終止
Kitchen : chú fáng 厨房
Attack : jìn gōng 进攻
Light : guāng 光
Ordinary / General : pǔ tòng 普通
Quiet : ān jìng 安静
Relief : fàng xīn 放心
Care : guān xīn 关心 / guān huái 关怀
Health : wèi shēng 卫生 / jiàn kāng 健康
Illness / Disease : bìng zhèng 病症
Far : yuǎn 远
Soon : mǎ shàng 马上
Same : yí yàng 一样
Rest : xiū xi 休息
Comb : shū zǐ 梳子
Before : zhī qián 之前
After : hòu lái 後來
Later : chí yī diǎn 迟一点
Miss : xiǎng niàn 想念
Thinking About You : xiǎng zhe nǐ 想著你
Medicine : yào 药
Which : nǎ xiē 哪些
Gift : lǐ wù 礼物
Pass Through / Pass Test : tōng guò 通过
Elevator / Escalator : diàn tī 电梯
Scissors : jiǎn dāo 剪刀
Knife : dāo 刀
Safe : ān quán 安全
On Time : àn shí 按时
To Arrange / Plan : ān pái 安排
Protect : bǎo hù 保护
Meet : jiàn miàn 见面
Fair : gōng píng 公平
Dirt / Earth : chén 陈
Take your time : màn màn lái 慢慢来
Holiday : gōng xiū 公休
Recreational Vehicle (RV) : fáng chē 房车
Politics : zhèng zhì 政治
Ridiculous, Absurd : huāng miù 荒谬
Famous : zhù míng 著名
Nature : zì rán 自然
Desert : shā mò 沙漠
Shower : xǐ zǎo 洗澡
Massage : àn mó 按摩
